WWWWWWWWWWWW
WW        WW
WWW W WWW WW
S   W  WW WW
WWWWWWWWW WW
WW   W WW WW
WWWWWW WW WW
W      WW WW
WWWWWWWWW WW
WWWWWWWWWXWW
